30 70 10 10 10 32 32 60.0 60.0 0.0 0.0 320.0 0.0
2.0 2.0
DATA/Tiles/brick_wall.png
DATA/Tiles/red_brick_wall.png
DATA/Tiles/brick_background.png
DATA/Tiles/brick_background.png
DATA/Tiles/main_door.png
DATA/Tiles/dungeon_1.png
DATA/Tiles/dungeon_2.png
DATA/Tiles/dungeon_3.png
DATA/Tiles/dungeon_4.png
DATA/Tiles/sword_silver.png
DATA/Tiles/bow.png
DATA/Tiles/wand_blue.png
DATA/Tiles/armour_gold.png
DATA/Tiles/key_frag1.png
DATA/Tiles/key_frag2.png
DATA/Tiles/key_frag3.png
DATA/Tiles/arrow.png
111111111111111111111111
133333333334333333333331
133333333000000000333331
133333333333333333333331
100000033333333333333331
133333333000000000000001
133333330033333333333331
133303033033333333333331
133333333033333333333331
111113333033333333333331
133333333033333333333331
133333333033333333333331
130333333033333333333331
130000000033333333333331
133333333333333333331331
111111111111111111111331
133333333333333333333331
133333333333333333333331
133333333333333333333331
133033333333333333001111
133000000000000000033331
133333333333333333333331
133333333333333333333331
133333333333333333333331
133330003333333333333331
133333300000000000000001
133333333333333333333331
100033333111111111111131
133000003333333111111131
133333300000033333333331
133333333333000000333331
133333333333333330003331
133111111333333333333331
133333333333333333300001
133111113333330000003331
133333333333333333333331
133333300000000003333331
133333333330333333333331
133333333030333333333331
100000000030333333333331
133333333330333311113331
133333333330333333333331
100003000000333333333331
1343U3333333333333333331
111111111111111111111111
