30 220 30 30 30 32 32 60.0 30.0 0.0 0.0 320.0 0.0
2.0 2.0
DATA/Tiles/brick_wall.png
DATA/Tiles/red_brick_wall.png
DATA/Tiles/brick_background.png
DATA/Tiles/brick_background.png
DATA/Tiles/main_door.png
DATA/Tiles/dungeon_1.png
DATA/Tiles/dungeon_2.png
DATA/Tiles/dungeon_3.png
DATA/Tiles/dungeon_4.png
DATA/Tiles/sword_silver.png
DATA/Tiles/bow.png
DATA/Tiles/wand_blue.png
DATA/Tiles/armour_gold.png
DATA/Tiles/key_frag1.png
DATA/Tiles/key_frag2.png
DATA/Tiles/key_frag3.png
DATA/Tiles/arrow.png
111111111111111111111111
133333333333333333333331
111111111111111111111131
133333333333333333111331
131111111111333311133331
131333333333311113333331
131331111111111333311111
131133333333333333333331
131111111111111111111111
133333333333333333333331
111111111111111111111131
133333333333333333333331
131111111111111111111111
133333333333333333333331
111113111111111111111111
111113331111111111111111
111111133331111111111111
111111111331111111111111
111111111133311111111111
111111111111331111111111
111111111111133111111111
111111111111113311111111
111111111111111331111111
111111111111111331111111
111111111111111331111111
111111111111111331111111
111111111111111311111111
111111111111111311111111
111111111111133311111111
111111111113331111111111
111111111133333111111111
111111111131113111111111
111111111113113111111111
111111111133113311111111
111111111113311311111111
111111111113111333111111
111111111113333333111111
111111111133111133311111
111111133331113333111111
111111111131113111111111
111111133331113333111111
111111111131111113331111
111113333331113333331111
111111111131311133331111
111111111131111111333111
111111111133111113333111
111111111333111113111111
111111133311111113111111
111113331111111113111111
111113111111111113111111
111333333111111113311111
113333311111111111311111
111331111111111111311111
111133331111111111331111
113333311111111111131111
111133331111111111133111
113333311111111111133111
113331111111111111113111
111133311111111111113311
111111333333111111111311
111111111113333331111311
111111111111111133111311
111111111111111113333311
111111111111111111113331
111111111111111113333311
111111111111111333311111
111111111113333311111111
111111113333111111111111
111133333111111111111111
111331111111111111111111
113311111111111111111111
113331111111111111111111
111133111111111111111111
111113331111111111111111
111111133311111111111111
111111111331111111111111
111111111133311111111111
111111111113331111111111
111111111111333111111111
111111111111113311111111
111111111111111331111111
111111111111111331111111
111111111111111331111111
111111111111111331111111
111111111111111311111111
111111111111111311111111
111111111111133311111111
111111111113331111111111
111111111133333111111111
111111111131113111111111
111111111133113111111111
111111111133113311111111
111111111113311311111111
111111111113111333111111
111111111113333333111111
111111111113111113311111
111111133333113333111111
111111111131113111111111
111111133331113333111111
111111111131111113331111
111113333331113333331111
111113333311311133331111
111111111331111111333111
111111111133111113333111
111111113333111113111111
111111133111111113111111
111113331111111113111111
111113111111111113311111
111333333111111111311111
113333311111111111311111
111331111111111111311111
111133331111111113331111
113333311111111111131111
111133331111111111133111
113333311111111111131111
113331111111111111133111
111133311111111111113311
111111333333111111111311
111111111113333331111311
111111111111111133111311
111111111111111113333311
111111111111111111113331
111111111111111113333311
111111111111111333311111
111111111113333311111111
111111133333111111111111
111133331111111111111111
111331111111111111111111
113311111111111111111111
113111111111111111111111
113333111111111111111111
111113331111111111111111
111111133311111111111111
111111113331111111111111
111111111133311111111111
111111111113331111111111
111111111111333111111111
111111111111133311111111
111111111111113331111111
111111111111111331111111
111111111111111331111111
111111111111111331111111
111111111111111311111111
111111111111111311111111
111111111111133311111111
111111111113331111111111
111111111133333111111111
111111111133113111111111
111111111113113111111111
111111111133113111111111
111111111131313311111111
111111111133111333111111
111111111113333333111111
111111111113111113311111
111111133333113333111111
111111111131113111111111
111111133331113333111111
111111111131111113331111
111113333331113333331111
111111111333333333331111
111111111111111111333111
111111111133333333333111
111111111331111111111111
111111133333333333111111
111113333111111113111111
111113311111111113311111
111333333111111111311111
113333311111111111311111
111331111111111111331111
111133331111111111131111
113333311111111111131111
111133331111111111133111
113333311111111111133111
113331111111111111113111
111133311111111111113111
111111333333111111113311
111111111113333331111311
111111111111111133111311
111111111111111113333311
111111111111111111113331
111111111111111113333311
111111111111111333311111
111111111113333311111111
111111113333111111111111
111133333111111111111111
111331111111111111111111
133333333333333333333331
133333333333333333333331
133333333333333333333331
133333333333333333333331
133333333333333333333331
133333333333333333333331
133333333333333333333331
111111111111111111111111
