30 70 10 20 30 32 32 60.0 30.0 0.0 0.0 320.0 0.0
5.0 2.0
DATA/Tiles/brick_wall.png
DATA/Tiles/red_brick_wall.png
DATA/Tiles/brick_background.png
DATA/Tiles/brick_background.png
DATA/Tiles/main_door.png
DATA/Tiles/dungeon_1.png
DATA/Tiles/dungeon_2.png
DATA/Tiles/dungeon_3.png
DATA/Tiles/dungeon_4.png
DATA/Tiles/sword_silver.png
DATA/Tiles/bow.png
DATA/Tiles/wand_blue.png
DATA/Tiles/armour_gold.png
DATA/Tiles/key_frag1.png
DATA/Tiles/key_frag2.png
DATA/Tiles/key_frag3.png
DATA/Tiles/arrow.png
111111111111111111111111
143333333333333333333331
111111111111111111333331
133333333333333333333331
133333133333333333333331
133333111111111111111111
133333331133333333333331
111113333133333333333331
133333333133333333333331
133300000133333333333331
133333333133333333333331
133333333133333333333331
131333333133333333333331
131111111133333333333331
133333333333333300000331
133333333333330000333331
100000000000000000333331
133333333333333333330001
133333333333333330000331
133333333333333000111331
131111111111111111133331
133333333333333333333031
100000000000000333000031
133333333333333300000031
133331113333333333333331
133333311111111111111111
133333333333333333333331
111133033000000000000031
133111113333333000000031
133333311111133333333331
133333333333111111333331
133333333333333331113331
133000000333300033333331
133333333300333333311111
133000003333331111113331
133333333300333333333331
133333311111111113333331
133003333331333333333331
133333333131333300003301
111111111131333033333001
133333333331333300000001
133333333331333333333331
111113111111000000003331
1343O3333333333333333331
111111111111111111111111
