30 70 10 20 20 32 32 60.0 30.0 0.0 0.0 320.0 0.0
5.0 2.0
DATA/Tiles/brick_wall.png
DATA/Tiles/red_brick_wall.png
DATA/Tiles/brick_background.png
DATA/Tiles/brick_background.png
DATA/Tiles/main_door.png
DATA/Tiles/dungeon_1.png
DATA/Tiles/dungeon_2.png
DATA/Tiles/dungeon_3.png
DATA/Tiles/dungeon_4.png
DATA/Tiles/sword_silver.png
DATA/Tiles/bow.png
DATA/Tiles/wand_blue.png
DATA/Tiles/armour_gold.png
DATA/Tiles/key_frag1.png
DATA/Tiles/key_frag2.png
DATA/Tiles/key_frag3.png
DATA/Tiles/arrow.png
111111111111111111111111
143333333333333333333331
100000000000000000333331
133333333333333333333330
133333033333333333333331
133333000000000000000001
133333330033333333333331
100003333033333333333331
133333333033333333333331
133333333033333333333331
133333333033333333333331
133333333033333333333331
130333333033333333333331
130000000033333333333331
133333333333333333333331
133333333333333333333331
133333333333333333333331
133333333333333333333331
133333333333333333333331
133333333333333333000331
111111111111111111111131
133333333333333333111331
130111111111333311133331
130333333333311113333331
130331111111111333300001
130033333333333333333331
131111131111111111111111
133333333333333333333331
100000000000000000000031
133333333333333333333331
130000000000000000000001
133333333333333333333331
100003000000000000000001
100003330000000000000001
100000033300000000000001
100000000330000000000001
100000000033300000000001
100000000003330000000001
100000000000333000000001
100000000000003300000001
133333333330333333333331
133333333030333333333331
100000000030333333333331
133333333330333311113331
133333333330333333333331
100003000000333333333331
134B3I333333333333333331
111111111111111111111111
