237 60 100 50 25 32 32 180.0 180.0 0.0 0.0 0.0 0.0
5.0 50.0
DATA/Tiles/water.png
DATA/Tiles/blocker.png
DATA/Tiles/sand.png
DATA/Tiles/stone_grass_ground.png
DATA/Tiles/main_door.png
DATA/Tiles/dungeon_1.png
DATA/Tiles/dungeon_2.png
DATA/Tiles/dungeon_3.png
DATA/Tiles/dungeon_4.png
DATA/Tiles/sword_silver.png
DATA/Tiles/bow.png
DATA/Tiles/wand_blue.png
DATA/Tiles/armour_gold.png
DATA/Tiles/key_frag1.png
DATA/Tiles/key_frag2.png
DATA/Tiles/key_frag3.png
DATA/Tiles/arrow.png
111111111111111111111111111111111111111111111111111111111111111111111111111111111111111111111111111111111111111111111111111111111111111111111111111111111111111111111111111111111111111111111111111111111111111111111111111111111111111111111
1                                                                                                22222222222222222                                                                                                                          1
1                                                                                                22222222222222222                                                                                                                          1
1           2222222                                                                            2222222222622222222222222                                                                                                                    1
1          2222222222222                                                             22222222222222222222222222222222222222                                                                         22222222222222                          1
1       222222223222222                                                                  22222222222222222222222222222222                                                                        22222222222222222222                       1
1     2222222225222222222222                                                                222222222222222222222                                                                        2222222222222222222222222222222                    1
1    2222232222222222222222222                                                                222222222222                                                                          222222222222222222222222222222222                       1
1       2222222233222222                                                                          22222                                                                          22222222222222                  222222222222               1
1         222222222222                                                                            222222                                                                             222222222222                  22222222                 1
1           222222                                                                              22222222                                                                                22222222222222      2222222222                      1
1             22222                                                                          22222222222222                                                                                       2222222222222                             1
1               22222                                                                 222222222222222222222222222                                                                                    2222222222222222222222222              1
1                 222222                                                            2222222                 222222222222222                                                                        222222222222222222222                    1
1                 22322222                                                       22222222                      2222222222222222                                                                               222222222222222222222         1
1                  2222222                                                   22222222                               222222222222                                                                     22222222222222222222222222             1
1                   222222222222                                        22222222                                         22222222222222                                                   222222222222222222222222222222222                 1
1                       222222222222222222                           22222222                                      2222222222222                                                   2222222222222222                                         1
1     2                       222222232222222222222                2222   222           22222222                       222222222222                                               222222222222222222222222222222                            1
1   22222                  2222222222222222222222222222             2222  2222        2222222222222                  222222222222                                                        222222222222222222                                 1
1  22S222                2222222222222222322222222222222222           222222          222222W222222               2222222222                                                                  22222222222222222222222222                    1
1  232222             2222222222222222222222222222222222222222222        22222           2222222222222222222222222222222222222                                                                        2222222222222222222222                1
1 222222            222222322222232222222222222232222222222222          2222                 2222    222222222222222      222222222222                                                             2222222222222222P2222222222222           1
1 222                2222222222222222232222222222222232222222222        222222222                                          22222222                                                                        22222222222222222                1
1  222                  22222222222222322222222222222222222222          2222                                                2222222222                                                                        2222222222222222              1
1  222                    2222222222222222222222222222222                222222                                           2222222                                                                        22222222222     22222222222        1
1   222                     22232222           222222222                  222                                           222222                                                                               2222222222222222               1
1  222                      222222222       22222222                      222222                                      2222222                                                                                          2222222222           1
1 222                           2222222222222222222223222                    22222222                               22222222                                                                                    222222222222222222222       1
1  22222                       22222222         222222222                       2222222                            2222222222                                                                                222222222222222222             1
1    222222                     22222             22222222                         222222222222222222222222222222222222                                                                           2222222222222222222222                    1
1       22222222                   222222222222222222                                        2222222222222222                                                                          222222222222222222222                                1
1   22223222222222                     222222222222222222                           222222222222222222222222222                                                   222222222222222222222222222222                                            1
1  22222222222222222                       22222222   22222                            222222222222222222222222222                               2222222222222222222222222222222                                                            1
1 2222222223222222222                         2222222222222                       2222222222222222222222222                           22222222222222222222222222222222                                                                      1
1 22322222222222222222                           222  222222222222222222222222222222222222222222222222222222222222222222222222222222222222222222222                                                                                         1
1 22222223222222222222                    222222222222222     222222222222222222222222222222222222222222222222222222222222222          222222222222222222222                                                                                1
1  22222222222222223                       22222222222222222222222222                                                      2222222222222222222222222222222222222                                                                            1
1   222222222322                                        22222222222222222222222222                               2222222222222222222222           22222222222222222                                                                         1
1       222222222222222                   2222222222222          2222222222222222222222222222222222222222222222222222       22222272222222222222222222222222                                                                                1
1             22222222222222222       222222222222222222 22222222222222222                22222222222222222222222222222222222222222222222222            22222222222222222222                                                                1
1                         222222222222222        2222222222222                 222222222222222222222222222222                                                       22222222222222222222                                                    1
1                             222222223222222222222222                 2222222222222222                                                                                      22222222222222222222222                                        1
1                           222222222222222222222222                22222222222222                                                                                     2222222222222222222222222222222222222222                             1
1           2222    222222222222222222                            222222222222222222                                                                                222222222222222222222222222222222222222222222222                        1
1       222222222222222222222222                              222222222222222222222222222222                                                                     222222            222222222           222222222222222222                   1
1 22222222222222222222222                                       222222223322222222222222232222222222222                                                             2222222222222222222222222222222222222222222222222                       1
12222222222222222222222                                                2222222222222222222222222222                                                                                   2222222222                                            1
12232222222222222                                                                  2222282222                                                                                                                                               1
1222222222223222222                                                                22222222222                                                                                                                                              1
111111111111111111111111111111111111111111111111111111111111111111111111111111111111111111111111111111111111111111111111111111111111111111111111111111111111111111111111111111111111111111111111111111111111111111111111111111111111111111111
